15 17
@@@@@@@@@@@@@@@@@
@@@@@@@@@@@@@@@@@
@@@@@@@@@@@@@@@@@
@@@@@@@@@@@@@@@@@
@@@@.........@@@@
@@@@.........@@@@
@@@@...***...@@@@
@@@@...***...@@@@
@@@@...***...@@@@
@@@@.........@@@@
@@@@.........@@@@
@@@@@@@@@@@@@@@@@
@@@@@@@@@@@@@@@@@
@@@@@@@@@@@@@@@@@
@@@@@@@@@@@@@@@@@
