@@@@@@
@....@
@.**.@
@.**.@
@....@
@@@@@@