11 11
@@@@@@@@@@@
@@@@@@@@@@@
@.........@
@.........@
@...***...@
@...***...@
@...***...@
@.........@
@.........@
@@@@@@@@@@@
@@@@@@@@@@@
